###############################
S           #                 #
#  #  ####  #  ####  #  #######
#  #  #     #     #  #        #
##########  #  #######  #######
#     #     #        #     #  #
#  #######  #  #  ####  ####  #
#  #           #     #     #  #
#  #######  #  #  #  #######  #
#  #     #  #  #  #     #     #
#  #  #  #######  #  #  ####  #
#     #           #  #  #     #
#######  ####  ####  ####  ####
#     #  #     #     #        #
#  ##########  ####  #  #  ####
#              #     #  #     #
#######  #  #######  #  ####  #
#        #  #     #     #     #
#  #  ####  #  #######  #######
#  #  #        #              E
###############################