#########################################
S #     #     #           #     #   #   #
# ##### ### # # ##### ##### ### ### # ###
#     #     #   #       #   #   #   # # #
# ####### ##### ##### ### # ##### ### # #
# # #     #   # # #     # #   #         #
# # # ##### # # # ### # # ### ### # #####
#     #     # #   # # # # # # # # # #   #
# # # ####### # ### ### # # ### # ### ###
# # # # #     # #   # #       #     # # #
####### ##### # # ### # ########### # # #
# # #     #     # # #       #     #   # #
# # ### ### ### # # ### ### ### ### ### #
# #         #       # # # #   #   # # # #
# ### ######### # # # # # ### # ### # # #
#     #         # # # #   #         #   #
# # # # # ##### # ### ####### ### ##### #
# # # # # #     #   #       # # #     # #
# # # ### ####### # ### ### ### ### # # #
# # # #         # #   #   # #   #   #   #
######### # ####### # # ### ### # ### ###
#         # #       #     #     # #   # #
####### ##### ### # # # ### ### # ##### #
# #     #   # #   # # # #     # # # # # #
# # # # # ####### ##### ##### ### # # # #
#   # #       #   # #       # #         #
##### ######### # # ### # ###############
#   #   # #   # #   #   # #     #   # # #
# ### ### # ########### # ### # # ### # #
#     # #       # #   # # #   # #   #   #
####### # ##### # # ##### ### ##### ### #
#   # #     #   # #   #       #     #   #
# ### ### ####### # # # # ### # # ### ###
#   # # #   #       # # # # #   #       #
# ### # # ####### ##### ### # # # #######
#       #   #     #     #     # #       #
# ##### # # # ### ### # ### # # ##### ###
# #       #   #       # #   # # #       #
# ### ##### ### ####### ####### # ### ###
#   # #     #     #     #       #   #   E
#########################################