#########################################
S # # #             #   #     #         #
# # # # ####### ####### # # # ### # #####
#   #     #   # # # #     # #     # #   #
### # ### # ### # # ##### # ####### # # #
# # #   #   #       # # # # #   #     # #
# # ##### ### ####### # # ##### # ### ###
#   # #     # # # #   #   #   #   #   # #
### # # ##### # # ### ### # ### ##### # #
#           # #         # #         #   #
##### ####### # ####### # # ##### ### # #
#   #     # #     #       # #     #   # #
# ### ##### ##### ##### ####### # ### # #
#       # #   #     # # # #   # #   # # #
### ### # # # ####### ### ### ####### # #
# #   # #   #     #         # #       # #
# # # ### ######### # ### ### ##### # # #
#   # #   #   #     #   #   # #     # # #
##### # # ### ### ########### # # # # ###
#     # #   #     #   #     #   # # #   #
######### ### ##### ##### ######### #####
#   #   #       #     #     # #     #   #
# ##### # # ### # ### # # # # ##### ### #
#         #   #   #   # # #     #   # # #
### # # ####### ########### # ### # # # #
#   # #   #   #           # #   # #     #
# ##### # # ########### # ##### ### ### #
#   # # # #       #     #   #         # #
# ### # ####### # # ### ### # ##### ### #
#     #   #     #   #   #       #   #   E
#########################################