#############################################################
S           #   #   #       # #           #   #     # # # # #
####### ### ### # ### ##### # # # # # ### # # # # ### # # # #
#         #       #   # #       # # # #     #   # # #   #   #
######### # ### ### ### ### ####### # ######### ### # ##### #
#       # # # #   # #         #   # #     #     #     #     #
# # ### # # # ####### ####### # ############# # ##### # # # #
# # #   # #   #     #   #   #     #   # #     #   # #   # # #
# ### ### ####### ### # # # ##### # # # # ### # ### ##### ###
#   # #     #     #   # # #   #     # #     # #       #   # #
# ### # ####### ##### # # # # # ##### # ####### # ### # # # #
# #       #   # #   # # # # #       # #   #     # #     #   #
# # # ##### # # # # # ### ##### ####### # ### ### # ### #####
# # # # #   #     #     # #   # # #     # # # #   # #       #
##### # # ############# ##### ### ##### ### # ######### # ###
#   #           #     #       #       # #   #     # #   #   #
# ### ##### ##### ##### ### ### ######### ### ##### #########
#       # # # #       #   #         #         #   #     # # #
##### # # # # ### ### # ### ##### ########### ### ##### # # #
# # # # #     # # #     #   # # # #       #       #         #
# # # ####### # # ##### ### # # ##### # ### ####### ### ### #
# #   #         # #   # #       #     #   #         #     # #
# ### # ####### # ### # # ########### # # ### ######### ### #
#   # #       # # #   # #       # #   # # #   #     #   # # #
# ### ### ########### ##### ### # ### # # # ##### # # ### ###
#     # #   #   #   #     # #     #   # #   #     # #     # #
### ### ##### ##### # ##### ##### # ####### # # ### ### ### #
# # #   #   #       #         #   #       # # # #   #     # #
# # # # # ######### # ### ### # ### # # ### ### ### ### # # #
#     #           #     # #   #   # # # #         #   # #   E
#############################################################
